EN               -- FI
------------------------------------------
lazy             -- laiska
eager            -- ahne
strict           -- tiukka, vaativa, ehdoton
non-strict       -- löyhä
expression       -- lauseke
denote           -- ilmaista, merkitä, osoittaa, tarkoittaa
evaluation       -- evaluointi, laskeminen, laskenta
semantic         -- merkitysopillinen, semanttinen
reduction        -- sieventäminen
graph reduction  -- verkonkudonta!
pure             -- puhdas
I/O              -- siirräntä
monad            -- monadi
constructor      -- konstruktori, muodostaja?
run-time system  -- suoritusympäristö
entry point      -- aloituspiste
action           -- toiminto, toimi, toimenpide
perform[ance]    -- suoritus, suorittaa, teko, toteuttaa, toteuttaminen
prefix           -- etuliite
infix            -- sisämerkintä
------------------------------------------
higher-kinded polymorphism   -- korkeamman asteen polymorfismi
referential transparency     -- viitteellinen läpinäkyvyys
function compotision         -- funktioiden koostaminen
call-by-ref/value/name/need
==========================================
https://www.reddit.com/r/programming/comments/ox6s/ask_reddit_what_the_hell_are_monads/coxiv/
* What the hell are monads? General model of computation that
  lets you pick and choose the environmental features that you
  want for your computations.
